NO t
SO t
WE t
NO
NO
EA t
F   9,5,8883









111111111111111111111
1                  N1
1                   1
1                   1
1                   1
111111111111111111111