NO t
SO t
WE t
NO
NO
EA t
F                                  9,5,8 








		  

            111111111111111111111111111111 
            1                             11
        11111                               11
            1111111                           1
                   11                   111111
                    11111111111111111111