NO t
SO t
WE t
NO
NO
EA t
F   9,5,888






111111111111111111111111111111
1.E                                  E
1 111111111111111111111
1 1                 1
1 1                  1
1  1                 1
1  1                 1
1 1111111111111111111
1
11111 111111111111111111 1111111111
1       1 11111111111111 111111111
 1     1
  1   1
   1 
   1
    1